
R 1440 900

F 100, 200 , 100
SO ./textures/red.XPM

C 135, 206, 235

NO ./textures/brown.XPM

S ./textures/barrel.xpm

WE ./textures/cyan.xpm

EA./textures/green.XPM


11111111111111111111111111111
10200000000010000000000000001
12000001000010000000000000201
10000001200010000001010000001
10000001111110000001010111111
100000010000000000010101
11111101000000000001010111111
10001000000000000001210000201
10201000000000000001010000001
10001000000000110011110111111
100010000000001000000101
10001000000000102000010111111
10001000000000100002010000001
10001000000000100000010000001
10001000111111111100111000001
10001000100000000000001000001
10001000102000000000201000001
10001000100000000000001000001
10000000102000000000201000N01
10000000100000000000001000001
11111111111111111111111111111
