R 1440 900

F 100, 200 , 100
SO ./textures/red.XPM

C 135, 206, 235

NO ./textures/brown.XPM

S ./textures/barrel.xpm

WE ./textures/cyan.xpm

EA./textures/green.XPM

11111111111111
10200000000001
10000000000000111111111
11111002000200000020001
    1000000000011111111
    100200020001
    100000000001     111111
    11111111000111111102001  111    111    1   1   1  1
    11111111000000000000001  1  1   1  1   1   1   1  1
           100000000000000111111    1111   1   1   1111
           100000N000002001  1  1   1  1   1   1   1  1
   111111111000000000000001  11111111  1111111111111  1
  1000000000000000000000001
  1000000000000000000000001
  1020020111111111111110011
  10000001            10001
  1020020011111111    100001
  10000000000000011111111101
   1111111111111000000000001
                11111100111
                     1001
             111     1001
            1000111111001
            1020000001111
            100011111
             111
