
R 1200 700

F 100, 200 , 100
SO ./textures/red.XPM

C 135, 206, 235

NO ./textures/brown.XPM

S ./textures/lamp.xpm

WE ./textures/cyan.xpm

EA./textures/green.XPM


11111111111111111111111111111
10200000000010000000000000001
12000001000010000000000000201
10000001200010000001000000001
10000001111110000001000111111
10000001000000000001000111111
11111101000000000001000111111
10001000000000000001200000201
10201000000000000001000000001
10001000000000110011100000001
10001000000000100000000000001
10001000000000102111111111111
10001000000000100100000000001
10001000000000100100000000001
10001000111111111100020000001
10001000100000000100000000001
10001000102000000100000000001
100010001000000001000N0000001
10000000102000000100000000001
10000000100000000100000000001
11111111111111111111111111111
